AKIK PORIBOHON: Gabtoli - Mirpur 1 - Mirpur 10 - Kalshi - Jamuna Future Park - Natun Bazar, - Badda 
TRUST LINE: Mirpur 10 - Cantonment - Banani - Notun Bazar 
TETULIA PORIBOHON: Shiya Masjid - Shyamoli - Agargaon - Mirpur 10 - Kalshi - Bisshoroad - Airport - Uttara - Abdullahpur 
JABALE NOOR: Agargaon - Mirpur 10 - Kalshi - Bisshoroad - Airport - Uttara - Abdullahpur 
OVIJAT PORIBOHON: Agargaon - Mirpur 10 - Kalshi - Bisshoroad - Airport - Uttara - Abdullahpur 
ALIF PORIBOHON: Mirpur Sony Cinema Hall - Mirpur 10 - Kazipara - Shewrapara - Mohakhali - Gulshan 1 - Badda - Rampura – Bonoshri
ROIS PORIBOHON: Mirpur Sony Cinema Hall - Mirpur 10 - Kazipara - Shewrapara - Mohakhali - Gulshan 1 - Badda - Rampura - Bonoshri
HIMACHOL PORIBOHON: Mirpur Sony Cinema Hall - Mirpur 10 - Kazipara - Shewrapara - Mohakhali - Gulshan 1 - Badda - Rampura - Khilgaon Khidma Hospital
PROJAPOTI PORIBOHON: Gabtoli - Mirpur 1 - Mirpur 10 - Kalshi - Bisshoroad - Airport - Uttara – Abdullahpur
NEW PALLABI EXPRESS: Gabtoli - Mirpur 1 - Mirpur 10 - Kalshi - Bisshoroad - Airport - Uttara – Abdullahpur
KONOK PORIBOHON: Gabtoli - Mirpur 1 - Mirpur 10 - Kalshi - Bisshoroad - Airport - Uttara - Abdullahpur
BOSUMOTI PORIBOHON: Gabtoli - Mirpur 1 - Mirpur 10 - Kalshi - Bisshoroad - Airport - Uttara - Abdullahpur - Tongi - Gazipur 
BRTC: Gabtoli - Mirpur 1 - Mirpur 10 - Kalshi - Bisshoroad - Airport - Uttara - Abdullahpur - Tongi - Gazipur 
ROBROB PORIBOHON: Gabtoli - Mirpur 1 - Mirpur 10 - Kalshi - Banani - Gulshan 2 - Gulshan 1 - Badda Link Road 
JABALE NOOR PORIBOHON: Gabtoli - Mirpur 1 - Mirpur 10 - Kalshi - Kuril Flyover - Natun Bazar 
BRTC: Gabtoli - Mirpur 1 - Mirpur 10 - Kazipara - Shewrapara - Mohakhali - Kakoli - Banani - Gulshan 2 - Natun Bazar - Badda – Rampura
 EVEREST PORIBOHON: Roopnagar Abasik - Mirpur 2 - Mirpur 1 - Khamarbari - Farmgate - Gulistan - Keraniganj 
MIRPUR MISSION PORIBOHON: Chiriyakhana - Mirpur 1 - Khamarbari - Farmgate - Press Club - Motijhil 
ITIHAS PORIBOHON: Mirpur 10 - Mirpur 2 - Mirpur 1 - Gabtoli - Savar - Nobinogor - Chondra 
BIHONGO PORIBOHON: Mirpur 12 - Mirpur 11 - Mirpur 10 - Kazipara - Shewrapara - Mohakhali - Gushan 1 - Badda - Natun Bazar \
DHAKA METRO SERVICE: Mirpur 1 - Kolyanpur - Shyamoli - Asadgate - Shukrabad - Kolabagan - Science Lab - New Market - Nilkhet - Azimpur 
ASHIRBAD PORIBOHON: Roopnagar Abasik - Mirpur 2 - Mirpur 1 - Kolyanpur - Shyamoli - Asadgate - Shukrabad - Kolabagan - Science Lab - New Market - Nilkhet - Azimpur 
BIHONGO PORIBOHON: Roopnagar Abasik - Mirpur 2 - Mirpur 1 - Kolyanpur - Shyamoli - Asadgate - Shukrabad - Kolabagan - Science Lab - New Market - Nilkhet - Azimpur
NEW VISION: Chiriyakhana - Mirpur 1 - Khamarbari - Farmgate - Press Club - Motijhil 
DISHARI PORIBOHON: Chiriyakhana - Mirpur 1 - Gulistan - Keraniganj - Babubazar Bridge 
TRANS SILVA LIMITED: Mirpur 1 - Technical - Kolyanpur - Asadgate - Kolabagan - Science Lab - Shahbag - Press Club - Gulistan - Motijhil - Jatrabari 
BIKOLPO SERVICE 1/E: Mirpur 14 - Mirpur 1 - Technical - Kolyanpur - Asadgate -Kolabagan - Science Lab - New Market - Nilkhet - Azimpur - TSC - Shahbag - Press Club - Gulistan - Tikatuli - Jatrabari 
ALIF (BENGAL) PORIBOHON: Mirpur 10 - Mirpur 1 - Mazar Road - Beri Badh - Ashuliya - Fantasy Kingdom - Nondon Park 
POLLOBI LOCAL SERVICE: Asadgate - Shyamoli - Kolyanpur - Technical - Mirpur 1 - Mirpur 2 - Mirpur 6 - Cholontika Mor - Mirpur 7 - Mirpur 11 - Mirpur 12 
BRIHOTTOR MIRPUR: Chiriyakhana, - Mirpur 1 - Gabtoli - Savar - Nobinogor – Chondra
TITAS PORIBOHON: Chiriyakhana, - Mirpur 1 - Gabtoli - Savar - Nobinogor - Chondra
 ETC PORIBOHON: Kalshi - Mirpur Sare 11 - Mirpur 10 - Kazipara - Shewrapara - IDB - Khamarbari - Farmgate - Karwanbazar - Shahbag - Gulistan - Sadarghat 
SHOKOLPO PORIBOHON: Chiriyakhana - Mirpur 1 - Mirpur 10 - Agargaon - Bijoy Sarani - Farmgate - Bangla Motor - Mogbazar - Malibag - Komlapur 
NOBOKOLI PORIBOHON: Mirpur 1 - Kolyanpur - Shyamoli - Agargaon - Notun Rasta - Mohakhali Flyover - Banani - Gulshan 2 - Notun Bazar
 BOISHAKHI PORIBOHON: Savar - Gabtoli - Kolyanpur - Shyamoli - Agargaon - Notun Rasta - Mohakhali - Gulshan 1 - Badda Link Road - Notun Bazar
 DESH BANGLA PORIBOHON: Gabtoli – Abdullahpur
RUPKOTHA PORIBOHON: Gabtoli - Abdullahpur 
KONOK PORIBOHON: Mirpur 12 - Mirpur 10 - Kakoli - Airport - Uttara - Abdullahpur 
PROVATI BONOSHRI PORIBOHON LIMITED: Gulistan - Polton - Malibag - Mogbazar - Saatrasta - Nabisko - Mohakhali - Bonani - Airport - Uttara - Abdullahpur - Tongi - Gazipur - Kaliyakoir 
6 NUMBER MOTIJHIL BANANI TRANSPORT LIMITED (LOCAL): Motijhil - Gulistan - Polton - Malibag - Mogbazar - Karwanbazar - Farmgate -Bijoy Sarani - Mohakhali - Gulshan 1 - Gulshan 2 - Notun Bazar
6 NUMBER MOTIJHIL BANANI TRANSPORT LIMITED (LOCAL): Motijhil - Gulistan - Polton - Malibag - Mogbazar - Saatrasta - Nabisko - Mohakhali - Gulshan 1 - Badda Link Road - Notun Bazar
4 NUMBER ALIKE TRANSPORT & BRTC ARTICULATED (WI-FI BUS): Balughat - Cantonment - Bijoy Sarani - Farmgate - Banglamotor - Shahbag - Polton - Gulistan - Motijhil 
AIRPORT – BANGABANDHU AVENUE PORIBOHON (LOCAL): Bongo Bazar - High Court - Shahbag - Farmgate - Mohakhali - Banani - Bisso Road - Airport - Uttara – Abdullahpur
 TORONGO BUS COMPANY: Mohammadpur - Asadgate - Farmgate - Mohakhali - Titumir College - Gulshan 1 - Badda - Notun Bazar 
TORONGO PLUS TRANSPORT LIMITED: Mohammadpur Bus Stand - Shankar - Dhanmondi 15 - Jhigatola - Science Lab - Shahbag - Kakrail - Malibag Railgate - Rampura Bazar - South Banashri 
BAHON PORIBOHON LIMITED: Mirpur 14 - Mirpur 10 - Mirpur 1 - Technical - Kolyanpur - Asadgate - Science Lab - Shahbag - Press Club - Motijhil - Komlapur - Mugda - Khilgaon 
NISORGO PORIBOHON LIMITED: Mirpur 14 Bus Stand - Mirpur 10 - Kazipara - Agargaon - Shyamoli - Asadgate - Mohammadpur - Dhakmondi 15 - Jhigatola - Science Lab - Dhaka College - New Market - Nilkhet - Eden College – Azimpur
 SHOTABDI PORIBOHON LIMITED: Mirpur 14 Bus Stand - Mirpur 14 - Mirpur 1 - Shyamoli - Asadgate - Mohammadpur - Shankar - Dhanmondi 15 - Jhigatola - Katabon - Shahbag - Gulistan - Motijhil - Notre Dame College 
CANTONMENT MINI SERVICE: Mirpur 14 - Kochukhet - Soinik Club - Kakoli - Banani 
RONGDHONU EXPRESS: Adabor - Shiya Masjid - Shyamoli - College Gate - Asadgate - Kolabagan - Science Lab - Shahbag - Kakrail - Fokirapul - Motijhil - Doyaganj 
BORAK PORIBOHON: Polashi - Meghna Ghat 
RAJDHANI EXPRESS: Shaymoli - Asadgate - Kolabagan - Science Lab - Katabon - Shahbag - Gulistan 
SUPER BUS: Gulistan - Shahbag - Farmgate - Shyamoli - Gabtoli - Savar - Nobinogor - Nandan Park 
DHAKA PORIBOHON: Gulistan - Shahbag - Farmgate - Banani - Uttara - Gazipur - Shib Bari 
BOLAKA PORIBOHON: Motijhil - Komlapur - Malibag - Mogbazar - Nabisko - Mohakhali - Banani - Khilkhet - Airport - Uttara - Tongi - Board Bazar - Gazipur - Shib Bari 
HIMALOY TRANSPORT: Modonpur (Narayanganj) - Jatrabari - Bangladesh Bank - Mogbazar - Mohakhali - Tongi Bridge
 LABBAYEK PORIBOHON: Jatrabari - Sayedabad - Mugda - Khilgaon - Malibag - Mogbazar - Karwan Bazar - Farmgate - Asadgate -Shyamoli - Gabtoli – Savar
 MIRPUR PORIBOHON SERVICE LIMITED: Mirpur 12 - Shewrapara - Gulistan Golap Shah Mazar 
BIHONGO PORIBOHON LIMITED: Mirpur 12 - Sadarghat Victoria Park
MIRPUR UNITED SERVICE LIMITED: Mirpur 12 - Sadarghat Victoria Park
 BRTC: Mirpur 12 - Mirpur 10 - Agargaon - Farmgate - Shahbag - Motijhil 
BIKOLPO AUTO SERVICE: Mirpur 12 - Mirpur 10 - Agargaon - Farmgate - Shahbag - Motijhil 
HAZI TRANSPORT: Mirpur 12 - Mirpur 10 - Agargaon - Farmgate - Shahbag - Motijhil - Notre Dame College
 WINNER TRANSPORT CO LTD: Eden College (Azimpur) - Kolabagan - Karwan Bazar - Nabisko - Mohakhali - Gulshan 1 - Badda Link Road - Kuril Bissho Road 
DIP BANGLA PORIBOHON LTD: Azimpur - City College - Kolabagan - Panthopoth - Karwan Bazar - Nabisko - Gulshan Link Road - Gulshan 1 - Kuril Bissho Road
SUCHONA BRF: Azimpur Etimkhana Mor - Kolabagan - Asadgate - Farmgate - Mohakhali - Banani - Uttara House Building 
FALGUN ART TRANSPORT PRIVATE LIMITED: Azimpur Girls School & College - Science Lab - Shahbag - Kakrail - Mouchak - Malibag - Rampura - Badda - Kuril Bissho Road - Uttara House Building 
BRTC: Eden College - Science Lab - Kolabagan - Asadgate - Khamarbari - Kakoli - Bonani – Abdullahpur
 SUPROVAT PORIBOHON: Sadarghat Victoria Park - Kakrail - Mouchak - Malibag Railgate - Badda - Notun Bazar - Basundhara - Kuril - Uttara - Tongi - Gazipur 
AZMERY GLORY LIMITED, SKYLINE EXPRESS LIMITED: Sadarghat Victorial Park - Gulistan - Kakrail - Malibag - Mogbazar - Mohakhali - Airport - Abdullahpur - Gazipur Bypass – Chondra
FTCL: Mohammadpur - Shankar - Star Kabab - Jhigatola - City College - Science Lab - Shahbag - Press Club - Gulistan - Arambag - Notre Dame College 
RAJA CITY PORIBOHON LIMITED: FTCL Mohammadpur - Shankar - Star Kabab - Jhigatola - City College - Science Lab - Shahbag - Press Club - Gulistan - Arambag - Notre Dame College 
FTCLMOITRI PORIBOHON LIMITED: Mohammadpur - Shankar - Star Kabab - Jhigatola - City College - Science Lab - Shahbag - Press Club - Gulistan - Arambag - Notre Dame College
MOITRI PORIBOHON LIMITED: Mohammadpur - Shankar - Star Kabab - Jhigatola - City College - Science Lab - Shahbag - Press Club - Gulistan - Arambag - Notre Dame College
 ATCL: Mohammadpur - Asadgate - Shukrabad - Kolabagan - City College - Science Lab - Katabon - Shahbag - Press Club - Gulistan - Arambag - Notre Dame College. 